File Name : 2018-19_nba_player-statistics.csv 
This data file provides total statistics for individual NBA players during the 2018-19 season. The variables consist:

player_name : Player Name
Pos :  (PG = point guard, SG = shooting guard, SF = small forward, PF = power forward, C = center) 
Age : Age of Player at the start of February 1st of that season.
Tm : Team
G : Games
GS : Games Started
MP : Minutes Played
FG : Field Goals
FGA : Field Goal Attempts
FG% : Field Goal Percentage
3P : 3-Point Field Goals
3PA : 3-Point Field Goal Attempts
3P% : FG% on 3-Pt FGAs
2P : 2-Point Field Goals
2PA : 2-point Field Goal Attempts
2P% : FG% on 2-Pt FGAs
eFG% : Effective Field Goal Percentage
FT : Free Throws
FTA : Free Throw Attempts
FT% : Free Throw Percentage
ORB : Offensive Rebounds
DRB : Defensive Rebounds
TRB : Total Rebounds
AST : Assists
STL : Steals
BLK : Blocks
TOV : Turnovers
PF : Personal Fouls
PTS : Points
NB: Players that were traded during the season may appear more than once (on more than one row) so it is important to handle these duplications appropriately.